S0 . G G . G . . . @ @ 
G  @ @ . . . . . . . . 
.  . . @ @ @ @ . G G G 
@  @ G . . . . . . . @ 
.  . . @ @ @ @ @ @ . . 
.  G G . . . . . . G . 
@  @ . @ @ @ @ @ @ @ . 
.  . . . . . . . . . X 
G  G @ @ @ @ @ @ @ @ X 
S1 . . . . . . . . . .